3,1,1,1,1,1,1,1,1,1,1,1,1,1,1,1,1,1,1,4
2,0,0,0,0,0,0,0,0,0,0,0,0,0,0,0,0,0,0,7
2,0,0,0,0,0,0,0,0,0,0,0,0,0,0,0,0,0,0,7
2,0,0,0,0,0,0,0,0,0,0,0,0,0,0,0,0,0,0,7
2,0,0,0,0,0,0,0,0,0,0,0,0,0,0,0,0,0,0,7
2,0,0,0,0,0,0,0,0,0,0,0,0,0,0,0,0,0,0,7
2,0,0,0,0,0,0,0,0,0,0,0,0,0,0,0,0,0,0,7
2,0,0,0,0,0,100,0,0,0,0,0,0,0,0,0,0,0,0,7
2,11,0,0,0,0,0,0,0,0,0,0,0,0,0,0,0,0,11,7
2,0,505,0,0,0,0,505,0,0,0,0,505,0,0,0,0,505,0,7
2,11,0,0,0,0,0,0,0,0,0,0,0,0,0,0,0,0,11,7
6,8,8,8,8,8,8,8,8,8,8,8,8,8,8,8,8,8,8,5