3,1,1,1,1,1,1,1,1,1,1,1,1,1,1,1,1,1,1,4
2,0,0,0,0,0,0,0,0,0,0,0,0,0,0,0,0,0,0,7
2,0,0,0,0,0,0,0,0,0,0,0,0,0,0,0,0,0,0,7
2,0,0,0,0,0,0,0,0,0,0,0,0,0,0,0,0,0,0,7
2,0,0,0,0,0,0,0,0,0,0,0,0,0,0,0,0,0,0,7
2,0,0,0,0,0,0,0,0,0,0,0,0,0,0,0,0,0,0,7
2,0,0,0,0,0,0,0,0,0,0,0,0,0,0,0,0,0,0,7
2,0,0,0,0,0,0,0,0,0,0,0,0,0,0,0,0,0,0,7
2,0,0,0,0,0,0,0,0,0,0,0,0,0,0,0,0,0,0,7
2,0,404,0,404,0,404,0,0,0,0,0,0,606,0,606,0,606,0,7
2,0,0,0,0,0,0,0,0,0,15,0,0,0,0,0,0,0,0,7
6,8,8,8,8,8,8,8,8,8,8,8,8,8,8,8,8,8,8,5