3,1,1,1,1,1,1,1,1,1,1,1,1,1,1,1,1,1,1,4
2,0,0,0,0,0,0,0,0,0,0,0,0,0,0,0,0,0,0,7
2,13,0,0,0,0,0,0,0,0,0,0,0,0,0,0,0,0,0,7
2,13,0,13,0,0,0,0,0,0,0,0,0,0,0,0,13,0,0,7
2,11,0,0,0,0,0,0,0,0,0,0,0,0,0,0,0,0,0,7
2,0,0,0,0,0,0,0,0,0,0,0,0,0,0,0,0,0,0,7
2,0,0,0,0,0,0,0,0,0,0,0,0,0,0,0,0,0,0,7
2,0,0,0,0,0,0,0,0,0,0,0,0,0,0,0,0,0,0,7
2,11,0,0,0,0,0,0,0,0,0,0,0,0,0,0,0,0,0,7
2,13,0,0,0,0,0,0,0,0,0,0,0,0,0,0,0,0,0,7
2,13,0,13,0,0,0,0,0,0,0,0,0,0,0,0,13,0,0,7
6,8,8,8,8,8,8,8,8,8,8,8,8,8,8,8,8,8,8,5